WWWWWWWWWWWWWWW
W             W
W             W
W             W
W             W
W             W
W             W
WS            W
W             W
W             W
W             W
W             W
W             W
W             W
WWWWWWWWWWWWWWW
WWWWWWWWWWWWWWW
W      S      W
W             W
WPPPPP        W
W             W
W        PPPPPW
W             W
WPPPPP        W
W             W
W        PPPPPW
W             W
WPPPPP        W
W             W
W             W
WWWWWWWWWWWWWWW
WWWWWWWWWWWWWWW
W   P  S  P   W
W   P     P   W
WPPPP     P   W
W         P   W
W         P   W
W         P   W
WPPP      P   W
W    PPPPPP   W
W    P        W
W             W
WPPPPP        W
W             W
W             W
WWWWWWWWWWWWWWW