WWWWWWWWWWWWWWW
W   W  E W    W
W   W    W    W
W   W    W    W
W   W    W    W
W   W    W    W
WWWWW    W    W
WS       W    W
WWWWWWWWWWWWWWW
W             W
W             W
W             W
W             W
W             W
WWWWWWWWWWWWWWW
WWWWWWWWWWWWWWW
W      S      W
W             W
WWWWWWWWWWWW  W
W             W
W  WWWWWWWWWWWW
W             W
WWWWWWWWWWWW  W
W             W
W             W
W             W
W             W
W             W
W      E      W
WWWWWWWWWWWWWWW
WWWWWWWWWWWWWWW
W      E      W
W             W
WPPPPPPPPPP   W
W             W
W             W
W   PPPPPPPPPPW
W             W
W             W
WPPPPPPPPPP   W
W             W
W             W
W             W
W      S      W
WWWWWWWWWWWWWWW
WWWWWWWWWWWWWWW
W      S      W
W             W
WWWWWWWWWWWW  W
W             W
W  WWWWWWWWWWWW
W             W
WWWWWWWWWWWW  W
W             W
W1            W
W             W
W            1W
W             W
W      E      W
WWWWWWWWWWWWWWW