WWWWWWWWWWWWWWW
W             W
W             W
W             W
W             W
W             W
W             W
WS           EW
W             W
W             W
W             W
W             W
W             W
W             W
WWWWWWWWWWWWWWW
WWWWWWWWWWWWWWW
W      S      W
W             W
WPPPPP        W
W             W
W        PPPPPW
W             W
WPPPPP        W
W             W
W        PPPPPW
W             W
WPPPPP        W
W             W
W      E      W
WWWWWWWWWWWWWWW
WWWWWWWWWWWWWWW
W   P  S  P E W
W   P     P   W
WPPPP     P   W
W         P   W
W         P   W
W         P   W
WPPP      P   W
W    PPPPPP   W
W    P        W
W             W
WPPPPP        W
W             W
W             W
WWWWWWWWWWWWWWW
WWWWWWWWWWWWWWW
W   P  E  P S W
W   P     P   W
WPPPP     P   W
W   W     P   W
W      W  P   W
W         P   W
WPPP      P   W
W    PPPPPP   W
W    P    P   W
W         P   W
WPPPPP    P   W
WWWWW     P   W
W   W         W
WWWWWWWWWWWWWWW