WWWWWWWWWWWWWWW
W             W
W             W
W             W
W             W
W             W
W             W
WP            W
W             W
W             W
W             W
W             W
W             W
W             W
WWWWWWWWWWWWWWW
WWWWWWWWWWWWWWW
W      P      W
W             W
W             W
W             W
W          WWWW
W             W
WWWW          W
W             W
W          WWWW
W             W
WWWW          W
W             W
W             W
WWWWWWWWWWWWWWW