WWWWWWWWWWWWWWW
W   W  E W    W   //This is a level for testing purposes
W   W    W    W
W   W    W    W
W   W    W    W
W   WDDDDW    W
WWWWW    W    W
WS       W    W
WWWWWWWWWWWWWWW
W             W
W             W
W             W
W             W
W             W
WWWWWWWWWWWWWWW
WWWWWWWWWWWWWWW
W             W   //Level 1, meant to teach movement
W             W
W             W
W             W
WWWWWWWWWWWWWWW
W             W
WS           EW
W             W
WWWWWWWWWWWWWWW
W             W
W             W
W             W
W             W
WWWWWWWWWWWWWWW
WWWWWWWWWWWWWWW
W             W   //Level 2, meant to teach about Gems
W             W
W             W
W             W
WWWWWWWWWWWWWWW
WG            W
WE  GGGGGGG  SW
WG            W
WWWWWWWWWWWWWWW
W             W
W             W
W             W
W             W
WWWWWWWWWWWWWWW
WWWWWWWWWWWWWWW
W             W   //Level 3, meant to teach about pits
W             W
W             W
W             W
WWWWWWWWWWWWWWW
W   P  G  PE  W
WS  P  P  PPPGW
W   G  P  G   W
WWWWWWWWWWWWWWW
W             W
W             W
W             W
W             W
WWWWWWWWWWWWWWW
WWWWWWWWWWWWWWW
W             W   //Level 4, meant to teach enemies
W             W
W             W
W             W
WWWWWWWWWWWWWWW
W          S  W
W             W
WGG          1W
W             W
W1          GGW
W             W
WGG          1W
W      E      W
WWWWWWWWWWWWWWW
WWWWWWWWWWWWWWW
WGGGG DED GGGGW   //Level 5, meant to teach about Dirt. Player should be stuck here at first playthrough
W     DDD     W
W             W
WPPD      1DPPW
W             W
W      D      W
W      2      W
WPPD1      DPPW
W             W
W      D      W
W             W
WPPD       DPPW
W      S      W
WWWWWWWWWWWWWWW