WWWWWWWWWWWWWWW
W   W  E W    W
W   W    W    W
W   W    W    W
W   W    W    W
W   W    W    W
WWWWW    W    W
WS       W    W
WWWWWWWWWWWWWWW
W             W
W             W
W             W
W             W
W             W
WWWWWWWWWWWWWWW
WWWWWWWWWWWWWWW
W      S      W
W             W
WWWWWWWWWWWW  W
WG  G  G  G  GW
W  WWWWWWWWWWWW
WG  G  G  G  GW
WWWWWWWWWWWW  W
W             W
W             W
W             W
W             W
W             W
W      E      W
WWWWWWWWWWWWWWW
WWWWWWWWWWWWWWW
WGG    E      W
WGG           W
WPPPPPPPPPPGGGW
W             W
W             W
WGGGPPPPPPPPPPW
W             W
W             W
WPPPPPPPPPPGGGW
W             W
W             W
W             W
W      S      W
WWWWWWWWWWWWWWW
WWWWWWWWWWWWWWW
W      S      W
W             W
WWWWWWWWWWWW  W
W             W
W  WWWWWWWWWWWW
W             W
WWWWWWWWWWWW  W
WGGG          W
W1            W
W             W
W            1W
W             W
W      E      W
WWWWWWWWWWWWWWW
WWWWWWWWWWWWWWW
WGGGGW E WGGGGW
W    W 2 W    W
W1           1W
W             W
W            1W
W             W
W             W
W1            W
W             W
W             W
W            1W
W             W
W      S      W
WWWWWWWWWWWWWWW